0 0 0 0 0 0 0 0 0 0 0 0 0 0 0 0 0 0 0 0 0 0 0 0 0 0 0 0 0 0 0 0 0 0 0 0 0 0 0 0 0 0 0 0 0 0 0 0 0 0
0 4 4 1 1 1 1 1 1 1 9 1 1 1 1 1 1 1 1 1 1 1 1 1 1 1 1 1 1 1 1 1 1 1 1 1 1 1 1 1 1 1 1 1 1 1 5 5 5 5
0 4 4 1 1 1 1 1 1 1 9 1 1 1 1 1 1 1 1 1 1 1 1 1 1 1 1 1 1 1 1 1 1 1 1 1 1 1 1 1 1 1 1 1 1 1 5 5 5 5
0 4 1 1 1 1 1 1 1 9 9 1 1 1 1 1 1 1 1 1 1 1 1 1 1 1 1 1 1 1 1 1 1 1 1 1 1 1 1 1 1 1 1 1 1 1 5 5 5 5
0 1 1 1 1 1 1 1 1 1 9 1 1 1 1 1 1 1 1 1 1 1 1 1 1 1 1 1 1 1 1 1 1 1 1 1 1 1 1 1 1 1 1 1 1 1 5 5 5 5
0 1 1 1 1 1 1 1 1 1 9 1 1 1 1 1 1 1 1 1 1 1 1 1 1 1 1 1 1 1 1 1 1 1 1 1 1 1 1 1 1 1 1 1 1 1 5 5 5 5
0 1 1 1 1 1 1 1 1 1 9 1 1 1 1 1 1 1 1 1 1 1 1 1 1 1 1 1 1 1 1 1 1 1 1 1 1 1 1 1 1 1 1 1 1 1 5 5 5 5
0 1 1 1 1 1 1 1 1 1 9 1 1 1 1 1 1 1 1 3 3 3 1 1 1 1 1 1 1 1 1 2 1 1 1 1 1 1 1 1 1 1 1 1 1 1 5 5 5 5
0 1 1 1 1 1 1 1 1 1 9 1 1 1 1 1 1 1 3 3 3 3 3 3 1 1 1 1 1 1 1 1 1 1 1 1 1 1 4 4 4 1 1 1 1 1 5 5 5 5
0 1 1 1 1 1 1 1 1 9 1 1 1 1 1 1 1 1 3 3 3 3 3 3 1 1 1 1 1 1 1 1 1 1 1 1 1 1 4 4 4 4 1 1 1 1 5 5 5 5
0 1 1 1 1 1 1 1 1 9 1 1 1 1 1 1 1 3 3 3 3 3 3 3 3 1 1 1 9 1 1 1 1 1 1 1 1 1 4 4 4 4 1 1 1 1 5 5 5 5
0 1 1 1 1 1 1 1 1 9 1 1 1 1 1 1 1 3 3 3 7 7 3 3 3 1 1 1 9 1 1 1 1 1 1 1 1 1 4 4 4 4 1 1 1 1 5 5 5 5
0 1 1 1 1 1 1 1 9 9 1 1 1 1 1 1 1 8 3 3 3 3 3 3 3 1 1 1 9 1 1 1 1 1 1 1 1 1 1 4 4 1 1 1 1 1 5 5 5 5
0 9 9 9 9 9 9 9 9 9 9 1 1 1 1 1 1 3 3 3 3 3 3 3 3 3 1 1 9 9 1 1 1 1 1 1 1 1 1 1 1 1 1 1 1 1 5 5 5 5
0 1 1 1 1 1 1 1 9 9 9 1 1 1 1 1 1 3 3 3 3 3 3 3 3 3 1 1 9 9 1 1 1 1 1 1 1 1 1 1 1 1 1 1 1 1 5 5 5 5
0 1 1 1 1 1 1 1 1 1 1 9 9 1 1 1 1 3 3 3 3 3 8 3 3 3 1 1 9 9 1 1 1 1 1 1 1 1 1 1 1 1 2 1 1 1 5 5 5 5
0 1 1 1 1 1 1 1 1 1 1 1 9 9 1 1 1 1 3 3 3 3 8 3 3 3 1 1 1 9 1 1 1 1 1 1 1 1 1 1 1 1 1 1 1 1 5 5 5 5
0 1 1 1 1 1 1 1 1 1 1 1 1 9 1 1 1 1 3 3 3 3 3 3 3 3 1 1 1 9 9 1 1 1 1 1 1 1 1 1 1 1 1 1 1 1 5 5 5 5
0 1 1 1 1 1 1 1 1 1 1 1 1 9 9 1 1 1 3 3 3 3 3 3 3 3 1 1 1 9 9 1 1 1 1 1 1 1 1 1 1 1 1 1 1 1 5 5 5 5
0 1 1 1 1 1 1 1 1 1 1 1 1 1 9 9 1 1 1 3 3 3 3 3 3 3 1 1 1 9 1 1 1 1 1 1 1 1 1 1 1 1 1 1 1 1 5 5 5 5
0 1 1 1 1 1 1 1 1 1 1 1 1 1 9 9 1 1 1 3 3 3 3 3 3 3 3 1 1 9 1 1 1 1 1 1 1 1 1 1 1 1 1 1 1 1 5 5 5 5
0 1 1 1 1 1 1 1 2 1 1 1 1 1 9 9 1 1 1 3 3 7 3 3 3 3 3 1 1 9 9 1 1 1 1 1 1 1 1 1 1 1 1 1 1 1 5 5 5 5
0 1 1 1 2 1 1 1 1 1 1 1 1 1 9 9 1 1 1 1 3 7 3 3 3 3 3 1 1 9 9 1 1 1 1 1 1 1 1 1 1 1 1 1 1 1 5 5 5 5
0 1 1 2 2 2 2 2 2 1 1 2 1 1 9 9 1 1 1 1 3 3 3 3 3 3 3 1 1 1 9 9 1 1 1 1 1 1 1 1 1 1 1 1 1 1 5 5 5 5
0 1 1 2 2 2 2 2 2 1 1 2 2 1 9 9 1 1 1 1 1 3 3 3 3 3 3 3 1 1 9 9 1 1 1 1 1 1 1 1 1 1 1 1 1 1 5 5 5 5
0 1 1 1 2 2 2 2 2 1 1 1 1 1 9 9 1 1 1 1 1 3 3 3 3 3 3 3 1 1 1 9 9 1 1 1 1 1 1 1 1 1 1 1 1 1 5 5 5 5
0 1 1 1 2 2 2 2 2 2 1 1 1 1 1 9 9 1 1 1 1 1 3 3 3 3 3 3 1 1 1 9 9 1 1 1 1 1 1 1 1 1 1 1 1 1 5 5 5 5
0 1 1 1 2 2 2 2 2 2 2 1 1 1 1 9 9 9 1 1 1 1 3 3 8 3 3 3 3 1 1 1 9 1 1 1 1 1 1 1 1 1 1 1 1 1 5 5 5 5
0 1 1 1 2 2 2 2 2 2 2 2 1 1 1 1 9 9 9 1 1 1 3 3 3 3 3 3 3 1 1 1 9 1 1 1 1 1 1 2 1 1 1 1 1 1 5 5 5 5
0 1 1 1 2 2 2 2 2 2 2 2 1 1 1 1 1 9 9 9 1 1 1 3 3 3 3 3 3 3 1 1 9 1 1 1 1 1 1 1 1 1 1 1 1 1 5 5 5 5
0 1 1 1 1 1 1 1 2 2 2 2 2 1 1 1 1 1 9 9 1 1 1 3 3 3 3 3 3 3 1 1 9 1 1 1 1 1 1 1 1 1 1 1 1 1 5 5 5 5
0 1 1 1 1 1 1 1 2 2 2 2 2 1 1 1 1 1 1 9 9 1 1 3 3 3 3 3 7 3 1 1 9 1 1 1 1 1 1 1 1 1 1 1 1 1 5 5 5 5
0 1 1 1 1 1 1 1 2 2 2 2 2 1 1 1 1 1 1 9 9 1 1 3 3 3 3 3 7 1 1 1 9 9 1 1 1 1 1 1 1 1 1 1 1 1 5 5 5 5
0 1 1 1 1 2 2 1 2 2 2 2 2 2 1 1 1 1 1 9 9 1 1 3 3 3 3 3 3 1 1 1 9 9 1 1 1 1 1 1 1 1 1 1 1 1 5 5 5 5
0 1 1 1 1 1 1 1 1 1 2 2 2 2 1 1 1 1 1 9 9 1 1 1 3 3 3 3 1 1 1 1 9 9 1 1 1 1 1 1 1 1 1 1 1 1 5 5 5 5
0 1 1 1 1 1 1 1 1 1 1 1 1 1 1 1 1 1 1 9 9 1 1 1 3 3 3 1 1 1 1 1 9 9 1 1 1 1 1 1 1 1 1 1 1 1 5 5 5 5
0 1 1 1 1 1 1 4 4 4 4 4 1 1 1 1 1 1 1 9 9 1 1 1 3 3 3 1 1 1 1 1 9 9 1 1 1 1 1 1 1 1 1 1 1 1 5 5 5 5
0 1 1 1 1 1 4 4 4 4 4 4 4 4 1 1 1 1 1 9 9 1 1 1 3 3 1 1 1 1 1 1 1 9 1 1 1 1 1 1 1 1 1 1 1 1 5 5 5 5
0 1 1 1 1 1 1 4 4 4 4 4 4 1 1 1 1 1 1 9 9 1 1 1 8 1 1 1 1 1 1 1 1 9 9 1 1 1 1 1 1 1 1 1 1 1 5 5 5 5
0 1 1 1 1 1 1 1 1 1 1 1 1 1 1 1 1 1 1 9 9 1 1 1 3 1 1 1 1 1 1 1 1 1 9 9 1 1 1 1 1 1 1 1 1 1 5 5 5 5
0 1 1 1 1 1 1 1 1 1 1 1 1 1 1 1 1 1 9 9 9 1 1 1 1 1 1 1 1 1 1 1 1 1 9 9 1 1 1 1 1 1 1 1 1 1 5 5 5 5
0 1 1 1 1 1 1 1 1 1 1 1 1 1 1 1 1 1 9 9 1 1 1 1 1 1 1 1 1 1 1 1 1 1 1 9 1 1 1 1 1 1 1 1 1 1 5 5 5 5
0 1 1 1 1 1 1 1 1 1 1 1 1 1 1 1 1 1 9 1 1 1 1 1 1 1 1 1 1 1 1 1 1 1 1 9 1 1 1 1 1 1 1 1 1 1 5 5 5 5
0 1 1 1 1 1 1 1 2 1 1 1 1 1 1 1 1 9 9 1 1 1 1 1 1 1 1 1 1 2 1 1 1 1 1 9 1 1 1 1 1 1 1 1 1 1 5 5 5 5
0 1 1 1 1 1 1 1 1 1 1 1 1 1 1 1 1 9 1 1 1 1 1 1 1 1 1 1 1 1 1 1 1 1 1 9 1 1 1 1 1 1 1 1 1 1 5 5 5 5
0 1 1 1 1 1 1 1 1 1 1 1 1 1 1 1 9 1 1 1 1 1 1 1 1 1 1 1 1 1 1 1 1 1 1 9 1 1 1 1 1 1 1 1 1 1 5 5 5 5
0 1 1 1 1 1 1 1 1 1 1 1 1 1 1 1 9 1 1 1 1 1 1 1 1 1 1 1 1 1 1 1 1 1 1 1 9 1 1 1 1 1 1 1 1 1 5 5 5 5
0 1 1 1 1 1 1 1 1 1 1 1 1 1 1 9 9 1 1 1 1 1 1 1 1 1 1 1 1 1 1 1 1 1 1 1 9 1 1 1 1 1 1 1 1 1 5 5 5 5
0 1 1 1 1 1 1 1 1 1 1 1 1 1 1 9 1 1 1 1 1 1 1 1 1 1 1 1 1 1 1 1 1 1 1 1 9 1 1 1 1 1 1 1 1 1 5 5 5 5
0 0 0 0 0 0 0 0 0 0 0 0 0 0 0 0 0 0 0 0 0 0 0 0 0 0 0 0 0 0 0 0 0 0 0 0 0 0 0 0 0 0 0 0 0 0 5 5 5 5