0 0 0 0 0 0 0 0 0 0 0 0 0 0 0 0 0 0 0 0 0 0 0 0 0 0 0 0 0 0 0 0 0 0 0 0 0 0 0 0 0 0 0 0 0 0 0 0 0 0
0 1 1 2 1 1 1 1 1 1 1 2 1 1 1 2 1 1 1 1 1 1 2 1 1 1 6 6 6 6 6 6 6 6 6 3 3 9 3 8 3 7 3 3 3 3 3 3 3 0
0 1 1 1 2 1 1 1 1 2 1 1 1 1 2 1 1 1 2 1 1 1 1 2 1 1 6 6 6 5 5 6 6 6 6 3 3 3 3 7 3 3 3 3 7 3 3 3 3 0
0 1 2 1 1 1 9 1 1 1 0 1 2 1 1 1 1 2 1 1 1 2 1 1 1 1 6 6 5 5 5 5 6 6 6 3 3 3 3 3 3 3 3 3 3 3 3 7 3 0
0 1 1 1 1 1 1 1 2 1 1 1 1 1 1 2 1 1 1 1 2 1 1 1 2 1 6 6 5 5 6 5 5 6 6 3 3 7 3 3 3 3 7 3 3 3 3 3 3 0
0 1 1 2 1 1 1 1 1 1 2 1 1 2 1 1 1 1 1 1 1 1 1 1 1 1 6 6 6 6 6 6 5 6 6 3 3 3 3 3 3 3 3 3 3 3 3 3 3 0
0 2 1 1 1 1 2 1 1 1 1 1 1 1 1 1 2 1 1 2 1 1 1 2 1 1 5 6 6 6 6 6 6 6 6 3 3 3 7 3 3 3 3 3 3 7 3 3 3 0
0 1 1 1 1 1 1 1 1 2 0 1 2 1 1 1 1 1 1 1 1 2 1 1 1 1 5 5 6 6 5 6 6 6 6 3 3 3 3 3 3 3 3 3 3 3 3 3 3 0
0 1 1 2 1 1 1 2 1 1 1 1 1 1 2 1 1 1 2 1 1 1 1 1 2 1 5 5 5 6 5 5 6 6 6 7 3 3 3 3 7 3 3 3 3 3 3 3 3 0
0 1 2 1 1 9 1 1 1 1 2 1 1 1 1 1 1 1 1 1 1 1 2 1 1 1 6 5 5 5 5 5 5 6 3 3 3 3 3 3 3 3 3 8 3 3 3 3 7 0
0 1 1 1 1 1 1 1 1 1 1 1 2 1 1 2 1 1 1 2 1 1 1 1 1 1 6 6 5 5 5 5 5 6 3 3 7 3 3 3 3 3 3 3 3 3 3 3 3 0
0 4 4 4 4 4 1 1 2 1 1 1 1 1 1 1 1 2 1 1 1 1 1 1 2 1 6 6 6 5 5 5 6 6 3 3 3 3 3 3 7 3 3 3 3 3 7 3 3 0
0 4 4 4 4 4 1 1 1 1 1 2 1 1 2 1 1 1 1 1 2 1 1 1 1 1 1 6 6 6 6 6 6 6 3 3 3 3 3 3 3 3 3 3 3 3 3 3 3 0
0 4 4 4 4 4 1 1 1 2 1 1 1 1 1 1 1 1 2 1 1 1 2 1 1 1 1 1 6 6 6 6 6 3 3 3 3 7 3 3 3 3 3 7 3 3 3 3 3 0
0 4 4 4 4 4 2 1 1 1 1 1 1 2 1 1 2 1 1 1 1 1 1 1 1 2 1 1 1 3 3 3 3 3 3 3 3 3 3 3 3 3 3 3 3 3 3 3 3 0
0 1 1 1 1 1 1 1 1 1 2 1 1 1 1 1 1 1 1 2 1 1 1 2 1 1 1 2 1 3 3 7 3 3 7 3 3 3 3 3 3 7 3 3 3 3 3 7 3 0
0 1 2 1 1 1 1 2 1 1 1 1 1 1 2 1 1 2 1 1 1 2 1 1 1 1 1 1 1 3 3 3 3 3 3 3 3 3 3 7 3 3 3 3 3 3 3 3 3 0
0 1 1 1 9 1 1 1 1 1 1 2 1 1 1 1 1 1 1 1 1 1 1 1 2 2 1 1 1 3 3 3 3 3 3 3 7 3 3 3 3 3 3 3 7 3 3 3 3 0
0 1 1 1 1 1 1 1 2 1 1 1 1 2 1 1 2 1 1 2 1 1 2 1 1 1 1 2 1 3 3 7 3 3 3 3 3 3 3 3 3 3 3 3 3 3 3 3 3 0
0 2 1 1 1 1 2 1 1 1 1 1 1 1 1 1 1 1 1 1 1 1 1 1 1 1 1 1 1 3 3 3 3 3 3 7 3 3 3 3 7 3 3 3 3 3 7 3 3 0
0 1 1 2 1 1 1 1 1 2 1 1 2 1 1 2 1 1 2 1 1 1 1 2 1 2 1 1 1 3 3 3 3 7 3 3 3 3 3 3 3 3 3 3 3 3 3 3 3 0
0 1 1 1 1 1 1 1 1 1 1 1 1 1 1 1 1 1 1 1 2 1 1 1 1 1 1 1 1 3 3 3 3 3 3 3 3 3 7 3 3 3 3 7 3 3 3 3 3 0
0 1 2 1 1 2 1 2 1 1 2 1 1 2 1 1 2 1 1 1 1 1 1 1 1 1 2 1 1 3 7 3 3 3 3 3 3 3 3 3 3 3 3 3 3 3 3 7 3 0
0 1 1 1 1 1 1 1 1 1 1 1 1 1 1 1 1 1 2 1 1 2 1 2 1 1 1 1 1 3 3 3 3 3 7 3 3 3 3 3 7 3 3 3 3 3 3 3 3 0
0 4 4 4 4 1 1 1 1 2 1 1 2 1 1 2 1 1 1 1 1 1 1 1 1 1 1 2 1 7 3 3 3 3 3 3 3 7 3 3 3 3 3 3 3 7 3 3 3 0
0 4 4 4 4 4 1 1 1 1 1 1 1 1 1 1 1 1 1 2 1 1 2 1 2 1 1 1 1 3 3 3 7 3 3 3 3 3 3 3 3 3 3 3 3 3 3 3 3 0
0 4 4 4 4 4 2 1 1 1 2 1 1 2 1 1 2 1 1 1 1 1 1 1 1 1 1 1 1 3 3 3 3 3 3 3 3 3 3 7 3 3 7 3 3 3 3 3 3 0
0 4 4 4 4 4 1 1 2 1 1 1 0 1 1 1 1 1 2 1 1 2 1 1 2 2 1 1 1 3 3 7 3 3 3 7 3 3 3 3 3 3 3 3 3 3 3 7 3 0
0 1 1 1 1 1 1 1 1 1 1 2 1 1 2 1 1 1 1 1 1 1 1 1 1 1 1 2 1 3 3 3 3 3 3 3 3 3 3 3 3 3 3 3 7 3 3 3 3 0
0 1 1 2 1 1 1 1 1 2 1 1 1 1 1 1 2 1 1 2 1 1 2 1 1 1 1 1 1 7 3 3 3 7 3 3 3 7 3 3 3 7 3 3 3 3 3 3 3 0
0 2 1 1 1 9 1 2 1 1 1 1 2 1 1 1 1 1 1 1 1 1 1 1 2 1 1 1 1 3 3 3 3 3 3 3 3 3 3 3 3 3 3 3 3 3 3 3 7 0
0 1 1 1 1 1 1 1 1 1 2 1 1 1 2 1 1 2 1 1 2 1 1 1 1 1 2 1 1 3 3 7 3 3 3 3 3 3 3 7 3 3 3 7 3 3 3 3 3 0
0 1 2 1 1 1 1 1 2 1 1 1 1 1 1 1 1 1 1 1 1 1 2 1 1 1 1 1 1 3 3 3 3 3 7 3 3 3 3 3 3 3 3 3 3 3 7 3 3 0
0 1 1 1 1 2 1 1 1 1 1 2 1 1 1 2 1 1 2 1 1 1 1 1 2 1 1 2 1 3 3 3 3 3 3 3 7 3 3 3 3 3 3 3 3 3 3 3 3 0
0 4 4 4 4 1 1 1 1 2 1 1 1 2 1 1 1 1 1 1 2 1 1 1 1 1 1 1 1 7 3 3 7 3 3 3 3 3 3 3 7 3 3 3 7 3 3 3 3 0
0 4 4 4 4 4 1 2 1 1 1 0 1 1 1 1 2 1 1 1 1 1 2 1 1 2 1 1 1 3 3 3 3 3 3 3 3 3 7 3 3 3 3 3 3 3 3 3 7 0
0 4 4 4 4 4 1 1 1 1 2 1 1 1 2 1 1 1 2 1 1 1 1 1 1 1 1 1 1 3 3 3 3 3 7 3 3 3 3 3 3 3 7 3 3 3 3 3 3 0
0 4 4 4 4 4 2 1 1 1 1 1 2 1 1 1 1 1 1 1 1 2 1 1 2 1 2 1 1 3 7 3 3 3 3 3 3 3 9 3 3 3 3 3 3 7 3 3 3 0
0 1 1 1 1 1 1 1 2 1 1 1 1 1 1 2 1 1 1 2 1 1 1 1 1 1 1 2 1 1 3 7 3 3 3 3 3 3 3 3 3 3 3 3 3 3 3 3 3 0
0 1 1 1 1 1 1 1 1 1 2 1 1 1 1 1 1 1 2 1 1 1 1 1 3 3 3 3 7 3 3 3 3 7 3 3 3 3 3 3 7 3 3 3 3 3 3 3 3 0
0 2 1 1 1 1 2 1 1 1 1 1 2 1 1 2 1 1 1 1 1 2 1 1 3 3 7 3 3 3 3 3 3 3 3 3 7 3 9 3 3 3 3 7 3 3 3 3 3 0
0 1 1 1 1 1 1 1 2 1 1 1 1 1 1 1 1 1 1 2 1 1 1 1 3 3 3 3 3 3 7 3 3 3 3 3 3 3 3 3 3 3 3 3 3 3 7 3 3 0
0 1 2 1 1 9 1 1 1 1 0 1 1 2 1 1 2 1 1 1 1 1 2 1 7 3 3 3 3 3 3 3 3 7 3 3 3 3 9 3 3 3 3 3 3 3 3 3 3 0
0 1 1 1 1 1 1 1 1 1 1 1 1 1 1 1 1 1 2 1 1 1 1 1 3 3 3 7 3 3 3 3 3 3 3 3 3 3 3 3 3 7 3 3 3 3 3 3 3 0
0 1 1 2 1 1 1 2 1 1 1 2 1 1 2 1 1 1 1 1 2 1 1 1 3 3 3 3 3 3 3 7 3 3 3 7 3 3 9 3 3 3 3 3 7 3 3 3 3 0
0 2 1 1 1 1 1 1 1 2 1 1 1 1 1 1 2 1 1 1 1 1 1 1 3 7 3 3 3 3 3 3 3 3 3 3 3 3 3 3 3 3 3 3 3 3 3 7 3 0
0 1 1 1 1 2 1 1 1 1 1 1 2 1 1 1 1 1 2 1 1 2 1 1 3 3 3 3 7 3 3 3 3 3 7 3 3 3 7 3 3 3 3 3 3 3 3 3 3 0
0 1 2 1 1 1 1 2 1 1 2 1 1 1 2 1 1 1 1 1 1 1 1 1 3 3 3 3 3 3 3 3 3 3 3 3 3 3 9 3 3 7 3 3 3 3 3 3 3 0
0 1 2 1 1 1 1 2 1 1 2 1 1 1 2 1 1 1 1 1 1 1 1 1 3 3 3 3 3 3 3 3 3 3 3 3 3 3 3 3 3 3 3 3 3 3 3 3 3 0
0 0 0 0 0 0 0 0 0 0 0 0 0 0 0 0 0 0 0 0 0 0 0 0 0 0 0 0 0 0 0 0 0 0 0 0 0 0 0 0 0 0 0 0 0 0 0 0 0 0